     ##########################
     ##########################
                 ##############
                 ##############
                ###############
#######              ##########
############     ##############
############     ##############
############     ##############
############     ##############
############     ##############
############     ##############
############      #############
############      #############
############      #############
###############################
###############################
###############################
###############################
###############################
###############################
###############################
###############################
###############################
###############################
###############################
###############################
###############################
###############################
###############################
###############################
###############################