   #   #    ####
            #  #
   #   #    #  #
##### #######  #
# #    #   #   #
# #        #   #
# #    #   #####
# ## #######   #
# #     # #    #
# #     # #    #
# #     # #    #
# ### ####### ##
#  #   #   #   #
#  #           #
#  #   #   #   #
################