   #   #    ####
            ####
   #   #    ####
##### ##########
###    #   #####
###        #####
###    #   #####
#### ######    #
###     ###    #
###     ###    #
###     ###    #
##### ####### ##
####   #   #   #
####           #
####   #   #   #
################